...;+...............
.xk..............;..
.fm....;;..;+.....;.
...........+........
....................
.;##................
.;;....#.......++...
......##-......+-...
.......-#.....####..
....................
....................
..####.....#-.......
...-+......-##......
...++.......#....;;.
................##;.
....................
........+...........
.;.....+;..;;....ng.
..;..............ly.
...............+;...